%%%%%%%%%%%%%%%%%%%%%%%%%%%%%%%%%%%%
%                      .  s       P%
% %%%%%%%%%%%%%%%%%%%%%%% %%%%%%%% %
% %%              %%%%%%%   %%     %
% %% % % % % %%%% %%%%%%%%% %% %%%%%
% %% % % % %             %% %%     %
% %% % % %.% % %%%%  %%%    %%%%%% %
% %  % % %   %    %% %%%%%%%%  .   %
% %% % % %%%%%%%% %%        %% %%%%%
% %%     %%       %%%%%%%%% %%%%   %
%    %%%%%% %%%%%%%      %% %% %%% %
%%%%%%      %       %%%% %% %      %
%      %%%%%% %%%%% %    %% %% %%%%%
% %%%%%%      %%      %%%%% %%     %
%        %%%%%% %%%%%%%%%%% %%  %% %
%%%%%%%%%%                  %%%%%% %
%.     s   %%%%%%%%%%%%%%%%        %
%%%%%%%%%%%%%%%%%%%%%%%%%%%%%%%%%%%%