%%%%%%%%%%%%%%%%%%%%%%%%%%%%%%%%%%%%
%     %       %         % s      . %
%     %       %         %   %%%%%% %
%     %       %             %%     %
%     %       %         %   %% %%%%%
%     %  %    %  %%%%%  %   %%     %
%     %  %    %  %   %  %   %%%%%% %
%     %  %    %  %%%%%  % .       P%
%     %  %    %  %   %  %%%%%%%%%%%%
%     %  %    %  %   %  %          %
%     %  %    %         %          %
%%%%%%%       %         %          %
% %       %%% %         %          %
% %%%%%%  % % %       %%%          %
% %     %%% %%%%%%%%%%%%%%%%%%%%%%%%
% %%%%%%%%                . %%%%%% %
%s         %%%%%%%%%%%%%%%%        %
%%%%%%%%%%%%%%%%%%%%%%%%%%%%%%%%%%%%