%%%%%%%%%%%%%%%%%%%%%%
% %%        % %      %
%    %%%%%% %P%%%%%% %
% %%%%        %      %
%    %%%%%%%% %% %%%%%
% %%%% %         %   %
% %      %%% %%%   % %
% %                  %
% %                  %
% %       %%%        %
% %                  %
% %                  %
%                    %
%% %%%%       %% %%% %
%.         %%        %
%%%%%%%%%%%%%%%%%%%%%%