%%%%%%%%%%%%%%%%%%%%
%..................%
%...............s..%
%........P.........%
%..................%
%............s.....%
%%%%%%%%%%%%%%%%%%%%
