%%%%%%%%%%%%%%%%%%%%%%
%P%%        % %      %
%    %%%%%% % %%%%%% %
%%%%%%        %      %
%    % %%%%%% %% %%%%%
% %%%% %         %   %
%        %%% %%%   % %
%%%%%%%%%%    %% %%% %
%.         %%        %
%%%%%%%%%%%%%%%%%%%%%%