%%%%%%%%%%%%%%%%%%%%%%
% %%  .     % %      %
%    %%%%%% % %%%%%% %
%%%%%%     P  %  .   %
%    % %%%%%% %% %%%%%
% %%%% %       . %   %
%    .   %%% %%%   % %
%%%%%%%%%%    %%%%%% %
%.   T     %%   .  R %
%%%%%%%%%%%%%%%%%%%%%%
